....................
........GGGG........
....................
.......######.......
G.G..............G.G
.G.G............G.G.
#:##....G.G.....###:
.........G..........
........####........
....................
...GGG........GGG...
...###........###...
....................
1.................X.
####################