...G.:..G.G..##.....
....G:...G.B.......X
.###########....####
.......GGG.#.....G.G
..........A#.##...GD
#::##..#############
....................
C.............G.....
##~##....G.G........
..G.......G........G
..~G.....###.....G##
...~...........G##..
...............#....
1.........G.........
######..#####..#####